0
"thanks for playing
#   #   ###   #   #
 # #   #   #  #   #
  #    #   #  #   #
  #    #   #  #   #
  #     ###    ###

#   #  #####  #   #
#   #    #    ##  #
# # #    #    # # #
# # #    #    #  ##
 # #   #####  #   #
