0
 ###
##f#####
#f     #
## # ###
 #m# #
 #m###
 ###
