2
  ###
  #f###
### fm#
#fm ###
### fm#
#fm ###
###M#
  ###
