2
  #####
 ##M#m##
##  #  ##
#m ### m#
## # # ##
#f # # f#
##     ##
 ##f#f##
  #####
