1
#########
# m#m#m #
#m     m#
## # # ##
#f  #  f#
## # # ##
#f     f#
# f#F#f #
#########
